10 15
1 13
0 0 0 0 0 0 0 0 0 0 0 1 1 1 1
0 1 1 1 1 1 1 1 O 1 1 1 1 1 1
0 1 1 1 1 0 0 0 0 0 0 0 1 1 1
0 1 1 O 1 0 0 0 0 0 0 0 0 0 0
0 1 1 1 1 0 0 0 0 0 0 0 0 0 0
0 0 0 1 1 1 O 1 1 1 1 1 1 0 0
0 0 0 0 0 0 0 0 0 0 1 1 1 1 O
1 1 1 0 0 0 0 0 0 0 1 1 1 1 1
1 G 1 1 1 1 1 1 1 1 1 1 1 0 0
1 1 1 1 0 0 0 0 0 0 0 0 0 0 0
O 1 1 8 1 5 1 6
O 3 3 3 8 5 8 6
O 2 5 6 8 5 8 6
O 1 6 14 8 5 8 6