9 14
5 1
0 0 0 C C C C C C C 0 0 0 0
0 0 0 C C C C C C C 0 0 0 0
1 1 1 1 0 0 0 0 0 1 1 1 0 0
1 1 1 0 0 0 0 0 0 0 1 1 0 0
1 1 1 0 0 0 0 0 0 0 1 1 0 0
1 1 1 0 0 1 1 1 1 C C C C C
1 1 1 0 0 1 1 1 1 C C C C C
0 0 0 0 0 1 G 1 0 0 C C 1 C
0 0 0 0 0 1 1 1 0 0 C C C C