9 15
4 1
0 0 0 0 0 0 0 0 0 1 1 1 0 0 0
0 0 0 0 0 0 0 0 0 1 1 1 0 0 0
0 0 0 0 0 0 0 0 0 1 1 1 0 0 0
1 1 1 1 1 1 0 0 0 1 1 1 1 1 1
1 1 1 1 T 1 0 0 0 1 1 1 1 G 1
1 1 1 1 1 1 0 0 0 1 1 1 1 1 1
0 0 0 0 0 0 0 0 0 1 1 1 0 0 0
0 0 0 0 0 0 0 0 0 1 1 1 0 0 0
0 0 0 0 0 0 0 0 0 1 1 1 0 0 0
T 1 4 4 1 10 7 10