8 15
3 1
0 0 0 0 0 0 0 0 1 1 1 1 0 0 0
0 0 0 0 0 0 0 0 1 1 1 1 0 0 0
1 1 1 0 0 0 0 0 1 0 0 1 1 1 1
1 1 1 1 1 1 1 1 1 0 0 0 1 G 1
1 1 1 0 0 0 0 1 1 X 0 0 1 1 1
1 1 1 0 0 0 0 1 1 1 0 0 1 1 1
0 1 1 0 0 0 0 1 0 0 0 0 0 0 0
0 0 1 1 1 1 1 1 0 0 0 0 0 0 0
X 1 4 9 6 3