5 15
1 1
1 1 1 1 0 0 0 1 0 0 0 1 1 1 1
1 1 1 1 0 0 0 1 0 0 0 1 1 T 1
1 1 1 1 1 1 1 1 1 1 1 1 1 1 1
0 0 0 0 0 0 1 G 1 0 0 0 0 0 0
0 0 0 0 0 0 1 1 1 0 0 0 0 0 0
T 1 1 13 1 2 1 12