6 15
4 1
0 0 0 0 0 0 1 1 1 1 0 0 1 1 1
1 1 1 1 0 0 1 1 X 1 0 0 1 G 1
1 1 O 1 0 0 1 1 1 1 0 0 1 1 1
1 1 1 1 0 0 1 1 1 1 0 0 1 1 1
1 1 1 1 0 0 1 1 1 1 0 0 1 1 1
1 1 1 1 0 0 1 1 1 1 0 0 0 0 0
O 1 2 2 4 4 4 5
X 1 1 8 4 10 4 11